%s An update is available=%s: Existe una actualización disponible
anonymous=anónimo
Author=Autor
Check For Updates=Buscar Actualizaciones
Checking connectivty=
checking=
Click here to install version %s=Pulse aquí para instalar la versión %s
Delete Plugin=
DOWNGRADE TO VERSION=VOLVER A LA VERSIÓN
Enter URL of remote plugin file or local plugin file=Introduzca la URL del plugin remoto o la ruta local del plugin
ERROR=ERROR
Install Plugin=Instalar Plugin
Install=Instalar
install=instalar
Installed Plugins=Plugins Instalados
Installing Update=Instalando Actualización
need check=necesita revisión
Next=Siguiente
No plugins installed=
No release notes available=Notas de la versión no disponibles
No response, aborting=
Plugin File=Archivo del Plugin
Plugin File Install Errors=
Plugin History=
Plugin Update Check=Buscar Actualizaciones del Plugin
Plugin=Plugin
Release Notes=Notas de la Versión
Remove Plugin=
remove=eliminar
Select local plugin file=Seleccione el archivo local del plugin
Stable=Estable
STALE=OBSOLETO
Support Thread=Sitio de Soporte
Uninstall=Desinstalar
Update All Plugins=Actualizar Plugins
Update Plugin=
Upgrade=Actualizar
View Release Notes=Ver Notas de la Versión

; Note: November 14, 2021 - 9 missing translations
